MemberComponentTemplate==生物组件项
Parameter==单个参数项
ParameterSet==多个参数项
EntityTemplate==实体项
ComponentTemplate==组件模板项

AccelerationFactor==加速因子，用于摩擦，冰块这种，比较原版玩家女性的因子高点，所以跑的快，可能用于冰面，其它的没试过有待测试
ActiveSlotIndex==激活的格子位置
AdjustableDelayGateBlockBehavior==延迟门行为
AICreature==生物的基本功能。就是生物需要的基本属性、掉落物品，给各种动物的父类继承，快速编辑AI
AimingSights==瞄准，玩家的瞄准行为，就是射箭、丢石头这种
Air==空气
AirCapacity==氧气容量
AirDrag==空气阻力
AllowManualWakeUp==
Alpaca==羊驼父系，老k旧案
Alpaca_Shorn==被修剪后的羊驼，老k旧案
Alpaca_White==白色羊驼，老k旧案
AlwaysEnabled==始终自动跳跃
AmbientSounds==环境声
AnimatedTextures==动画纹理
AreWeatherEffectsEnabled==天气效果启用
ArrowBlockBehavior==箭支的行为
AttackPower==生物攻击强度
AttackResilience==最大生命值
AttackSound==攻击发出的声音
AttackSoundMinDistance==能听到攻击声的距离
Audio==音效
AutoChaseMask==自动追逐
AutoDespawn==自动重生
AutoFeed==自动吃东西
AutoJump==自动跳跃、就是碰到台阶方块自己跳
AutoNearbyCreaturesHelp==附加生物自动帮助，就是摇人行为
AvoidFireBehavior==自动远离火
AvoidPlayerBehavior==自动查找玩家的行为
Barracuda==梭子鱼
Bass_Freshwater==淡水鲈鱼
Bass_Sea==海鲈鱼
BatteryBlockBehavior==电池块行为
Bear==熊的父系
Bear_Black==黑熊
Bear_Brown==棕熊
Bear_Polar==北极熊
Behavior==行为
BehaviorSelector==行为选择器
Beluga==白鲸
Bird==飞行的鸟的父系
BirdModel==鸟的模型
Bison==野牛
BlockBehavior==方块行为
BlockBehaviors==多方块行为
BlockEntities==多方块实体
BlockEntity==方块实体
BlockHighlight==方块的高亮
Blocks==方块
BlocksScanner==方块扫描器
BlocksTexture==方块材质纹理
Boat==船
BoatBlockBehavior==船的行为
Bodies==身体
Body==身体
BombBlockBehavior==炸弹方块行为，艺术就是爆炸
BottomSuckerBlockBehavior==底下吸盘方块行为
BoundingSphereRadius==边界球体半径
BowBlockBehavior==弓块行为
BoxSize==碰撞箱大小
Bread==面包，估计是食物标签
BreathingMode==呼吸模式
BucketBlockBehavior==桶方块行为
Bull==牛的父系
Bull_Black==黑公牛
Bull_Brown==棕公牛
Bull_White==白公牛
BulletBlockBehavior==子弹方块行为
ButtonBlockBehavior==按键方块行为
CactusBlockBehavior==仙人掌方块行为
Camel==骆驼
Camel_Saddled==驯服后的骆驼
CampfireBlockBehavior==篝火方块的行为
CanCanter==能乘骑，就是是否能骑上去
CanStrand===能游泳，可能吧
CanterLegsAngleFactor==乘骑后腿的角度因子
CanTrot==能小跑
CarpetBlockBehavior==地毯方块行为
Cassowary==食火鸟
CastsShadow==生物阴影，就是影子
Category==生物类别
CategoryIndex==生物类别ID
CattleDriveBehavior==驱逐牛的行为
CauseOfDeath==死亡原因
Cetacean==鲸目动物，就是生物类型
CetaceanBreatheBehavior==鲸目动物呼吸行为，减少空气含量，上岸一会就搁浅的行为
ChaseBehavior==追逐行为
ChaseNonPlayerProbability==追逐非玩家的生物的概率
ChaseOnTouchProbability==追逐点触概率，就是玩家点了动物，然后命中后判定一次点触概率，如果成功就会追逐玩家
ChaseWhenAttackedProbability==当受到攻击时追逐概率
Chest==胸部
ChestBlockBehavior==胸部方块行为，盔甲
Chunks==块
Class==源码中的类名(带命名空间)
Clothes==衣服，玩家衣服组件的
Clothing==衣服，衣服方块的
CollapsingBlockBehavior==折叠方块行为
CollapsingBlocks==折叠方块
Color==颜色
Component==组件
ConstantSpawn==恒定的重生
Coordinates==当前坐标
CorpseDuration==死亡消失时间
CoughSound==咳嗽声
CoughSoundMinDistance==咳嗽声音的距离，用于多人玩的时候检测朋友的咳嗽声
Cow==奶牛父系
Cow_Black==黑奶牛
Cow_Brown==棕奶牛
CraftingTable==合成台
CraftingTableBlockBehavior==合成台方块行为
CreativeFlySpeed==生物飞行速度
CreativeInventory==生物装备
CreativeTools==生物工具
Creature==生物
CreatureEggData==生物蛋数据
CreatureModel==生物模型
CreatureSounds==生物声音
CreatureSpawn==生物生成
CrossbowBlockBehavior==弩方块行为
CustomFootstepSounds==自定义脚步声
Damage==伤害
DayChaseRange==白天追逐的距离限制，过了就不追
DayChaseTime==白天追逐的时间限制，过了就不追
DayEntityTemplateName==白天变形的名称
DayRange==白天的领地距离，如果会主动追玩家，就会持续判定是否追击玩家
DeathTime==死亡时间
DebrisScale==碎片大小缩放
DebrisStrength==碎片强度
DebrisTextureSlot==碎片的纹理槽
Density==密度
Dependencies==依赖
Description==描述，生物的信息
DespawnTime==重生时间
DestructionSoundName==销毁声音名称
DiggingCracks==挖掘动画
DigInBlockName==挖掘中的方块名称叫什么，挖掘时传过来的值
DigInMudBehavior==挖掘在泥土上的行为
Dirt==泥土
DismountOffset==下马或下船位置
Dispenser==分配器
DispenserBlockBehavior==分配器方块行为
DisplayName==这个生物的名称
Donkey==驴
Donkey_Saddled==驯服后的驴
DoorBlockBehavior==门方块行为
Drawing==绘制
Duck==鸭子
DumpRiderBehavior==转为骑手的行为，就是骑上生物操控生物
EatPickableBehavior==生物寻找地上的食物吃掉的行为
EditableItemBlockBehavior==可编辑项目块行为
EggBlockBehavior==蛋方块的行为
EggTypeIndex==蛋的标签ID
ElectricBlockBehavior==电方块行为
Electricity==电力
EnvironmentBehaviorMode==环境行为模式
Explosions==爆炸
Explosives==炸药
ExplosivesBlockBehavior==爆炸物阻止行为
FallResilience==掉落抗性
FeedBehavior==饲料行为
Feet==脚
FemalePlayer==女玩家
FenceBlockBehavior==栅栏方块行为
FenceGateBlockBehavior==栅栏门方块行为
FertilizerBlockBehavior==肥料方块行为
FindPlayerBehavior==寻找玩家行为
FireBlockBehavior==火方块行为
FireDuration==火的燃烧持续时间
FireResilience==燃烧抗性
FireTimeRemaining==火的时间重存
FireworksBlockBehavior==烟花方块行为
FirstPersonModel==第一人称
Fish==鱼的父系
FishModel==鱼的模型
FishOutOfWaterBehavior==鱼离开水后的行为
FlightlessBird==大型鸟类的父系
FlightlessBirdModel==大型鸟类的模型
Flu==感冒
FluDuration==感冒周期
FluidBlockBehavior==流体方块行为
FluOnset==流感开始发作时间
FlyAnimationSpeed==飞行动物扇翅膀动画的播放速度
FlyAroundBehavior==环顾四周到处飞来飞去的行为
FlyAwayBehavior==飞行下来啄来啄去的行为
FlySpeed==飞行速度
Food==食物
FoodFactors==食物因子
FootstepSounds==脚步声
FourLeggedModel==四腿生物模型
Frame==框架
Fruit==水果
Furnace==熔炉
FurnaceBlockBehavior==熔炉方块行为
FurnitureBlockBehavior==家具方块行为
FurnitureDesigns==家具设计
FurnitureInventory==家具装备
FurnitureSet==家具套装
FurnitureSets==家具多种套装
GameInfo==游戏信息
GameMode==游戏模式
GamepadHelpMessageShown==游戏帮助信息查看
GameWidgets==游戏的各种界面
Giraffe==长颈鹿
Glass==草，食物标签
GlobalSpawnPosition==全球生成的位置，就是在地图生成
Glow==发亮
GlowingEyes==发光的眼睛，比如狼人夜晚眼睛发亮
GlowingEyesColor==发亮眼睛的颜色
GlowingEyesOffset==发光的眼睛的位置偏移
Gnu==角马
Grass==草，食物标签
GrassBlockBehavior==草方块行为
GrassTrapBlockBehavior==草陷阱障碍方块行为
GravestoneBlockBehavior==墓碑街区行为
Gui==游戏的UI显示
HammerBlockBehavior==家具锤方块行为
HandModelName==手部模型名称
HasVerticalTail==尾部有垂直
Head==头部
Heading==标题
Health==生命组件
HeatLevel==热的水平，温度环境的级别
HerdBehavior==牧群行为
HerdingRange==牧群范围，超过了就算被攻击也会回到族群
HerdName==族群名称叫什么
Hitpoints==攻击生命值
Horse==马的父系
Horse_Bay==赤色黑蹄马
Horse_Bay_Saddled==驯服后的赤色黑蹄马
Horse_Black==黑马
Horse_Black_Saddled==驯服后的黑马
Horse_Chestnut==赤色白蹄马
Horse_Chestnut_Saddled==驯服后的赤色白蹄马
Horse_Palomino==栗色马
Horse_Palomino_Saddled==驯服后的栗色马
Horse_White==白马
Horse_White_Saddled==驯服后的白马
HowlBehavior==生物吼叫行为
HowlSoundName==吼叫音效的名称
HumanModel==玩家模型
Hyena==鬣狗
IdleSound==生物平时发出的音效
IdleSoundMinDistance==能听到吼叫音效的最小距离
ImpactExplosivesBlockBehavior==冲击爆炸方块的行为
ImpactSounds==冲击声音
InAirWalkFactor==在空气中的摩擦力
Input==输入
Intro==介绍
IntroShip==船舶
Inventory==箱子组
InventoryBase==装备存库
InWaterBlockBehavior==在水方块中的行为
IsCreativeFlyEnabled==生物飞行启用中
IsEnabled==在启用中
IsOptional==是可选的
Items==物品
ItemsScanner==物品扫描器
IvyBlockBehavior==常春藤方块行为
Jaguar==美洲虎
JumpSpeed==跳跃速度
JumpStrength==跳跃强度
KeyboardHelpMessageShown==键盘帮助消息关闭
KillVerbs==杀死的名称是什么
LadderBlockBehavior==梯子方块行为
LadderSpeed==梯子爬行速度。任何生物的梯子爬行速度大于0，它就会爬梯子
LandAnimal==陆地生物父系
LastMilkingTime==最后一次送乳时间，奶牛的挤奶行为
LastRotTime==上次旋转时间
LayEggBehavior==下蛋行为
LayFrequency==躺的频率
LeavesToCheck==叶子的检测
LedBlockBehavior==LED方块行为
Legs==腿
Leopard==豹
Level==玩家等级
LightningIntensity==闪电强度
Lion==狮子
LoadOrder==加载顺序
Locomotion==运动属性组件
LookAroundBehavior==环顾四周，查看周围行为行为
LookAutoLevelX==查看自动级别X
LookAutoLevelY==查看自动级别Y
LookSpeed==抬头、低头的速度
Loot==战利品
LootDropped==战利品掠夺
LootOnFire==被燃烧后掉落的战利品
MagmaBlockBehavior==岩浆方块行为
MagnetBlockBehavior==磁铁方块行为
Magnets==磁铁
MalePlayer==男玩家
Mass==重量
MatchBlockBehavior==火柴方块行为
MaxDigInDepth==挖掘进度最大值
MaxSmoothRiseHeight==最大光滑上升高度
Meat==肉，食物标签
MemoryBankBlockBehavior==记录银行方块行为
Metal==金属
MetalLadder==金属条
MetersBlockBehavior==小麦方块行为
MilkRegenerationTime==牛奶再生时间
Miner==控制玩家的挖方块、放方块等操作的组件
MinFrictionFactor==最小摩擦系数
MinRange==最小距离
MoanSound==呻吟声
MoanSoundMinDistance==呻吟声可听最小范围
Model==模型
ModelName==模型名称
ModelsRenderer==模型渲染
Moose==驼鹿
Mount==骑马或乘船(挂载)
MountOffset==上马或上船位置
MoveAwayBehavior==移动离开行为
MoveLegWhenFeeding==当喂养食物的时候移动腿
MovingBlocks==移动方块
MovingBlockSets==移动方块集
MusketBlockBehavior==枪的方块行为
Name==名字
Names==名字
NextPlayerIndex==玩家的id，判定几号玩家
NightChaseRange==网上追逐的范围
NightChaseTime==晚上追逐的持续时间
NightEntityTemplateName==晚上变形的名称
NightRange==晚上自动追逐的距离
Noise==噪声
NutritionalValue==营养值
OnFire==着火中
OpenSlotsCount==打开插槽计数
Orca==虎鲸/逆戟鲸
Ostrich==鸵鸟
OuterClothingModel==外衣模型
PageIndex==页面索引
PainSound==疼痛声
PainSoundMinDistance==疼痛声可听范围
Palette==调色板
ParentBody==父级身体
ParentBodyPositionOffset==父级身体位置偏移
ParentBodyRotationOffset==父级身体旋转偏移
Particles==粒子
Pathfinding==寻路
PeckAnimationSpeed==啄的播放动画速度
PeckBehavior==啄行为
Pickables==可拾取
Pigeon==鸽子
Pilot==飞行员
Piranha==水虎鱼（食人鱼）
PistonBlockBehavior==活塞块行为
Pitch==投
Plant==植物
PlantBlockBehavior==植物方块行为
Player==玩家
PlayerIndex==玩家ID
Players==玩家父系
PlayerStats==玩家统计
PlayIntro==播放介绍
PollChunkCoordinates==调查块坐标
PollPass==调查通行位置
PollPoint==调查点
Position==位置
Postprocessor==后置处理器
PrepareOrder==准备顺序
Probability==概率
Project==项目，也就是存放存档子系统、实体、组件等数据的一个类
Projectiles==投掷物
PukeSound==呕吐声
PukeSoundMinDistance==呕吐声最小可听范围
RakeBlockBehavior==耙子方块行为
RandomFeedBehavior==随机饲料行为
RandomPeckBehavior==随机啄行为
RareIdleSound==罕见的声音
RareIdleSoundMinDistance==罕见的声音最小可听范围
Raven==乌鸦
Ray==鳐鱼父系
Ray_Brown==棕鳐鱼
Ray_Yellow==黄鳐鱼
Reindeer==驯鹿
Rhino==犀牛
Rider==乘骑
RiderOffset==乘骑偏移
Roll==摇晃
Rotation==旋转
RotBlockBehavior==腐烂方块行为
RotStep==腐烂时间
RunAwayBehavior==跑步离开行为
SaddleBlockBehavior==鞍方块行为
Sand==沙
SaplingBlockBehavior==树苗方块行为
Saplings==树苗
Satiation==饱满
Scale==缩放
ScaleUV==UV缩放
ScreenOverlays==屏幕叠加
Seagull==海鸥
Shadows==阴影
Shapeshifter==变形组件
Shark==鲨鱼父系
Shark_Bull==牛鲨
Shark_GreatWhite==大白鲨
Shark_Tiger==虎鲨
ShowEgg==是否可以查看蛋
Sickness==生病
SicknessDuration==生病持续时间
SignBlockBehavior==标志方块行为
SimpleModel==简单模型
Sky==天空
Sleep==疲倦
SleepStartTime==疲倦开始时间
Slots==插槽
SlotsCount==箱子的格子数
SneezeSound==打喷嚏声
SneezeSoundMinDistance==打喷嚏声最小可听距离
Snow==雪
SnowBlockBehavior==雪方块行为
Soft==软度
SoilBlockBehavior==土壤方块行为
SoundMaterials==音响材料
Sparrow==麻雀
Spawn==生成
SpawnTime==生成时间
SpikesBlockBehavior==尖峰方块行为
Squishy==湿软
StairsBlockBehavior==楼梯方块行为
Stamina==耐力
StareBehavior==凝视行为
StareRange==凝视距离
Stats==统计
SteedBehavior==骏马行为
Stone==石头
StubbornEndTime==顽固的结束时间
StubbornProbability==顽固概率
StubbornSteedBehavior==顽固的骏马行为
Subsystem==子系统
SummonBehavior==召唤行为
SwapUV==交换UV
SwimAnimationSpeed==游泳动画播放速度
SwimAroundBehavior==四处游来游去行为
SwimAwayBehavior==游泳离开行为
SwimSpeed==游泳速度
SwitchBlockBehavior==开关块行为
Temperature==温度
Terrain==地形
TerrainGenerationMode==地形生成模式
TerrainLevel==地形级别
Texts==文本
TextureOverride==纹理材质顺序
TextureSlot==纹理材质槽
ThrowableBlockBehavior==投掷物品行为
Tiger==老虎
Tiger_White==白虎
Time==时间
TimeOfDay==一天的时间
TimeOfDayMode==一天时间的模式
TimeOfDayOffset==一天时间的偏移
TorchBlockBehavior==火把方块行为
Torso==躯干
TotalElapsedGameTime==总共过去的世界
TrapdoorBlockBehavior==陷阱门方块行为
TreasureGeneratorBlockBehavior==宝藏生成器块行为
TruthTableCircuitBlockBehavior==电路块行为
TurnSpeed==旋转速度
Udder==乳房
Update==更新
UpdateOrder==更新顺序
UseCanterSound==挤奶用的声音
Velocity==速度
VitalStats==玩家体征，就是玩家的各种数值
VoltagesByCell==一个字典，存放在方块格子与电压的对应关系
WalkAnimationSpeed==步行动画速度
WalkAroundBehavior==走动走过行为
WalkBobHeight==步行高空
WalkFrontLegsAngle==走前腿的角度
WalkHindLegsAngle==走后腿的角度
WalkLegsAngle==走腿的角度
WalkSpeed==行走速度
WalkSpeedWhenTurning==步行速度当转动时
Water==水
WaterBlockBehavior==水方块行为
WaterDrag==水拖拽
WaterPlantBlockBehavior==水中植物方块行为
WaterSwayAngle==水中的摇摆角度
WaterTurnSpeed==水的旋转速度
Weather==天气
WeatherEndTime==天气结束时间
WeatherStartTime==天气开启时间
Werewolf==狼人
Wetness==湿度
WhistleBlockBehavior==哨子方块行为
Wildboar==野猪
Wolf==狼人
Wolf_Coyote==郊狼
Wolf_Gray==灰狼
Wood==木头
WoodBlockBehavior==木头方块行为
WoodenLadder==木头梯子
WorldName==世界名称
WorldSeed==世界种子
WorldSeedString==世界种子字符串
Zebra==斑马
实体模板==实体模板
子系统模板==子系统模板
组件模板==组件模板
